11111111111111111
100P0110000C00001
11000N001C0111111
10E0011111000N001
1000N001110000101
10C0000N0000011C1
11111111111111111