1111111111111
100P011110011
11000N00000C1
10E0111111111
1000N00111111
10C0000N000C1
1111111111111