1111111111111
1000000000001
10P00C0100C01
10000001E0001
1111111111111
