111111
1P11C1
100011
1CE011
111111