111111
1P11C1
100001
100001
1E0011
1C1001
111111