1111111111111
1000000000001
10P00C011C001
10000001E1001
1111111111111