11111111
11P00E01
100C0001
100C0001
100C0001
100C0001
100C0001
11111111